C;1;1;CN;CC
N;C;X;N;N;C
C;N;N;C;1;N
1;1;X;X;P;C
X;X;X;1;C;N