N;N;N;N;C;CC;CN
N;X;X;X;X;X;X;X
N;X;X;X;X;X;X;X
N;X;X;X;X;X;X;X
N;X;X;X;X;X;X;X
N;X;X;X;X;X;X;X
N;X;X;X;X;X;X;X
P;X;X;X;X;X;X;X